%%%%%%%%%%%%%%%%%%%%%%%%%%%%%%%%%%%%%
%.......%.%.%...........%...%.....%.%
%.%%%%%%%.%.%%%.%.%%%.%%%.%%%%%%%.%.%
%.......%.......%.%.....%.....%.%...%
%%%%%.%%%%%.%%%.%.%.%.%%%.%%%%%.%.%%%
%...%.%.%.%...%.%.%.%...%.%...%.%...%
%.%%%.%.%.%.%%%.%%%%%.%%%.%.%%%.%%%.%
%.......%.....%...%...%.....%.%.%...%
%%%.%%%%%%%%%.%%%%%%%.%%%.%%%.%.%.%.%
%.............%.......%.%...%.....%.%
%.%.%%%%%.%.%%%.%.%.%%%.%.%%%.%%%.%.%
%.%.%.....%.%.%.%.%.....%...%.%.%.%.%
%.%.%.%%%%%%%.%.%%%%%%%%%.%%%.%.%%%.%
%.%.%.%.....%...%.....%.....%...%...%
%%%.%%%.%.%%%%%.%%%%%.%%%.%%%.%%%%%.%
%.....%.%.%.....%.%.....%.%...%.%.%.%
%.%.%.%.%.%%%.%%%.%%%.%%%.%.%.%.%.%.%
%.%.%.%.%.................%.%.%.....%
%%%.%%%%%%%.%.%.%%%%%.%%%.%.%%%.%%%%%
%.......%.%.%.%.....%...%.....%.%...%
%%%%%.%.%.%%%%%%%%%.%%%%%%%%%%%.%.%%%
%...%.%...........%.%.....%...%.%...%
%.%%%.%%%%%.%%%%%%%%%.%%%%%.%.%.%%%.%
%.%...%......%........%.....%.......%
%.%.%.%%%%%.%%%.%.%.%.%.%%%%%%%%%%%%%
%.%.%...%.....%.%.%.%.......%...%.%.%
%.%.%%%.%%%.%.%.%.%%%%%%%%%.%%%.%.%.%
%.%...%.%...%.%.%...%.%...%.%.%.....%
%.%%%.%%%.%%%%%.%%%.%.%.%%%%%.%.%%%%%
%.......%...%.....%.%.....%...%.%...%
%%%.%.%%%%%.%%%%%.%%%.%%%.%.%%%.%.%%%
%.%.%.%.%.%.%.%.....%.%...%.%...%.%.%
%.%.%%%.%.%.%.%.%%%%%%%%%.%.%.%.%.%.%
%...%...%...%.................%.....%
%.%.%.%.%%%.%%%.%%%%%%%.%%%.%%%.%%%.%
%.%.%.%.......%...%.......%...%.%..P%
%%%%%%%%%%%%%%%%%%%%%%%%%%%%%%%%%%%%%