%%%%%%%%%%%%%%%%%%
%................%
%................%
%................%
%................%
%................%
%................%
%................%
%................%
%................%
%................%
%................%
%................%
%................%
%................%
%................%
%................%
%................%
%................%
%................%
%................%
%................%
%................%
%................%
%...............P%
%%%%%%%%%%%%%%%%%%