%%%%%%%%%%%%%%%%%%%%%%%%%%%%%
%...........................%
%%%%%%%%%%%%%%%%%%%%%.%%%%%.%
%...%%.%%%%%.%%.%%%%%.%%%%..%
%............%..............%
%.%%%..%%.%%%%%%%%.%%.%%%%..%
%.%%%%.%%.%%%%%%%%.%%.%%%%..%
%............%%....%%.......%
%%%%%%.%..%%.%%.%%%%%.%%%%..%
%%%%%%.%%..%.%%.%%%%%.%%%%..%
%%%%%%.%............%.%%%%..%
%%%%%%.%.%%....%%%%.%.%%%%..%
%........%........%.........%
%%%%%%.%.%%%%%.%%%%.%.%%%%..%
%%%%%%.%............%.%%%%..%
%%%%%%.%.%%%%%%%%.%.%.%%%%..%
%............%%.............%
%.%%%%.%%%%%.%%.%%%...%%%%..%
%.%%%%.%%%%%.%%.%%%%..%%%%..%
%...%%.................%....%
%%%.%%.%%.%%%%%%%%.%%..%.%..%
%%%.%%.%%.%%%%%%%%.%%.%..%..%
%......%%....%%....%%.......%
%.%%%%%%%%%%.%%.%%%%%%%%....%
%..........................P%
%%%%%%%%%%%%%%%%%%%%%%%%%%%%%